-485,285,30;-455,285,30;-425,285,30;-395,285,30;-365,285,30;-335,285,30;-305,285,30;-275,285,30;-245,285,30;-215,285,30;-185,285,30;-155,285,30;-125,285,30;-95,285,30;-65,285,30;-35,285,30;-5,285,30;25,285,30;55,285,30;85,285,30;115,285,30;145,285,30;175,285,30;205,285,30;235,285,30;265,285,30;295,285,30;325,285,30;355,285,30;385,285,30;415,285,30;445,285,30;475,285,30;505,285,30;-485,-285,30;-455,-285,30;-425,-285,30;-395,-285,30;-365,-285,30;-335,-285,30;-305,-285,30;-275,-285,30;-245,-285,30;-215,-285,30;-185,-285,30;-155,-285,30;-125,-285,30;-95,-285,30;-65,-285,30;-35,-285,30;-5,-285,30;25,-285,30;55,-285,30;85,-285,30;115,-285,30;145,-285,30;175,-285,30;205,-285,30;235,-285,30;265,-285,30;295,-285,30;325,-285,30;355,-285,30;385,-285,30;415,-285,30;445,-285,30;475,-285,30;505,-285,30;
-485,255,30;-485,225,30;-485,195,30;-485,165,30;-485,135,30;-485,105,30;-485,75,30;-485,45,30;-485,15,30;-485,-15,30;-485,-45,30;-485,-75,30;-485,-105,30;-485,-135,30;-485,-165,30;-485,-195,30;-485,-225,30;-485,-255,30;485,255,30;485,225,30;485,195,30;485,165,30;485,135,30;485,105,30;485,75,30;485,45,30;485,15,30;485,-15,30;485,-45,30;485,-75,30;485,-105,30;485,-135,30;485,-165,30;485,-195,30;485,-225,30;485,-255,30;
205,-255,30;235,-255,30;265,-255,30;295,-255,30;325,-255,30;355,-255,30;385,-255,30;415,-255,30;445,-255,30;475,-255,30;505,-255,30;265,-225,30;295,-225,30;325,-225,30;355,-225,30;385,-225,30;415,-225,30;445,-225,30;475,-225,30;505,-225,30;-245,-195,30;-215,-195,30;-185,-195,30;-155,-195,30;-125,-195,30;-95,-195,30;-65,-195,30;-35,-195,30;-5,-195,30;25,-195,30;55,-195,30;85,-195,30;115,-195,30;325,-195,30;355,-195,30;385,-195,30;415,-195,30;445,-195,30;475,-195,30;505,-195,30;
-455,-165,30;-425,-165,30;-395,-165,30;-365,-165,30;-335,-165,30;-305,-165,30;-275,-165,30;175,-135,30;205,-135,30;235,-135,30;265,-135,30;355,-105,30;385,-105,30;415,-105,30;445,-105,30;475,-105,30;505,-105,30;-155,-105,30;-125,-105,30;-95,-105,30;-65,-105,30;-35,-105,30;-5,-105,30;25,-105,30;55,-105,30;85,-105,30;-395,-75,30;-365,-75,30;-335,-75,30;-305,-75,30;-275,-75,30;-245,-75,30;-215,-75,30;-185,-75,30;235,-45,30;265,-45,30;175,-15,30;205,-15,30;-215,15,30;-185,15,30;-155,15,30;-125,15,30;-95,15,30;-65,15,30;-35,15,30;-5,15,30;25,15,30;55,15,30;85,15,30;115,15,30;145,15,30;-245,45,30;-275,45,30;-305,45,30;-335,45,30;325,45,30;355,45,30;385,45,30;415,45,30;445,45,30;475,45,30;-365,75,30;-395,75,30;-425,75,30;-455,75,30;
-275,135,30;-245,135,30;-215,135,30;-185,135,30;-155,135,30;-125,135,30;-95,135,30;-65,135,30;-35,135,30;-5,135,30;25,135,30;55,135,30;85,135,30;175,135,30;205,135,30;235,135,30;265,135,30;295,135,30;385,135,30;415,135,30;445,135,30;475,135,30;325,195,30;355,195,30;
