-485,285,30;-455,285,30;-425,285,30;-395,285,30;-365,285,30;-335,285,30;-305,285,30;-275,285,30;-245,285,30;-215,285,30;-185,285,30;-155,285,30;-125,285,30;-95,285,30;-65,285,30;-35,285,30;-5,285,30;25,285,30;55,285,30;85,285,30;115,285,30;145,285,30;175,285,30;205,285,30;235,285,30;265,285,30;295,285,30;325,285,30;355,285,30;385,285,30;415,285,30;445,285,30;475,285,30;505,285,30;-485,255,30;505,255,30;505,225,30;505,195,30;
-485,225,30;-485,195,30;-425,195,30;-395,195,30;-365,195,30;-335,195,30;-305,195,30;355,195,30;325,195,30;295,195,30;265,195,30;235,195,30;-485,165,30;235,165,30;505,165,30;
-485,135,30;-455,135,30;-425,135,30;-395,135,30;-365,135,30;-335,135,30;-305,135,30;-275,135,30;-245,135,30;-215,135,30;-185,135,30;-155,135,30;-125,135,30;-95,135,30;-65,135,30;-35,135,30;-5,135,30;25,135,30;55,135,30;85,135,30;115,135,30;145,135,30;175,135,30;205,135,30;235,135,30;505,135,30;
-485,105,30;235,105,30;505,105,30;475,105,30;445,105,30;415,105,30;385,105,30;-485,75,30;235,75,30;505,75,30;-485,45,30;-335,45,30;-305,45,30;-275,45,30;-245,45,30;-215,45,30;-185,45,30;-155,45,30;-125,45,30;-95,45,30;-65,45,30;-35,45,30;-5,45,30;25,45,30;55,45,30;85,45,30;115,45,30;235,45,30;505,45,30;-485,15,30;115,15,30;235,15,30;265,15,30;295,15,30;325,15,30;355,15,30;505,15,30;
-485,-15,30;115,-15,30;145,-15,30;235,-15,30;505,-15,30;-485,-45,30;-455,-45,30;-425,-45,30;-395,-45,30;-365,-45,30;-335,-45,30;-305,-45,30;-275,-45,30;-245,-45,30;-215,-45,30;-185,-45,30;-155,-45,30;-125,-45,30;-95,-45,30;-65,-45,30;-35,-45,30;115,-45,30;235,-45,30;505,-45,30;-485,-75,30;115,-75,30;235,-75,30;385,-75,30;415,-75,30;445,-75,30;475,-75,30;505,-75,30;-485,-105,30;115,-105,30;205,-105,30;235,-105,30;385,-105,30;505,-105,30;-485,-135,30;-215,-135,30;-185,-135,30;-155,-135,30;-125,-135,30;-95,-135,30;-65,-135,30;-35,-135,30;-5,-135,30;25,-135,30;55,-135,30;85,-135,30;115,-135,30;355,-135,30;385,-135,30;505,-135,30;
-485,-165,30;-5,-165,30;325,-165,30;355,-165,30;505,-165,30;-485,-195,30;-335,-195,30;-305,-195,30;-275,-195,30;-245,-195,30;-215,-195,30;-5,-195,30;505,-195,30;-485,-225,30;-5,-225,30;295,-225,30;325,-225,30;355,-225,30;385,-225,30;415,-225,30;445,-225,30;475,-225,30;505,-225,30;
-485,-255,30;-5,-255,30;505,-255,30;-485,-285,30;-455,-285,30;-425,-285,30;-395,-285,30;-365,-285,30;-335,-285,30;-305,-285,30;-275,-285,30;-245,-285,30;-215,-285,30;-185,-285,30;-155,-285,30;-125,-285,30;-95,-285,30;-65,-285,30;-35,-285,30;-5,-285,30;25,-285,30;55,-285,30;85,-285,30;115,-285,30;145,-285,30;175,-285,30;205,-285,30;235,-285,30;265,-285,30;295,-285,30;325,-285,30;355,-285,30;385,-285,30;415,-285,30;445,-285,30;475,-285,30;505,-285,30;
